{
  "maze": [
    ["#", "#", "#", "#", "#", "#", "#", "#", "#", "#", "#", "#", "#", "#", "#"],
    ["#", "S", " ", " ", "G", " ", " ", " ", " ", " ", "#", " ", "#", " ", "#"],
    ["#", " ", "#", "#", "#", " ", "#", "#", "#", "#", "#", " ", "#", " ", "#"],
    ["#", " ", " ", "G", "#", " ", "#", " ", " ", " ", " ", " ", " ", " ", "#"],
    ["#", " ", "#", "#", "#", "#", "#", " ", "#", "#", "#", " ", "#", " ", "#"],
    ["#", " ", " ", "G", " ", "T", "G", " ", " ", " ", "#", " ", "#", " ", "#"],
    ["#", " ", "#", " ", "#", "#", "#", "#", "#", "#", "#", " ", "#", "#", "#"],
    ["#", " ", "#", " ", " ", " ", " ", " ", " ", "G", "#", " ", " ", " ", "#"],
    ["#", "G", "#", "#", "#", "#", "#", " ", "#", "#", "#", "#", "#", "#", "#"],
    ["#", " ", " ", " ", " ", " ", "#", " ", " ", " ", " ", " ", "#", " ", "#"],
    ["#", " ", "#", "#", "#", "#", "#", " ", "#", " ", "#", "#", "#", "G", "#"],
    ["#", " ", " ", " ", " ", " ", "#", " ", "#", "G", " ", " ", "#", " ", "#"],
    ["#", " ", "#", " ", "#", "#", "#", "T", "#", "#", "#", " ", "#", " ", "#"],
    ["#", " ", "#", " ", " ", " ", "#", "G", "G", " ", "#", " ", "B", "E", "#"],
    ["#", "#", "#", "#", "#", "#", "#", "#", "#", "#", "#", "#", "#", "#", "#"]
  ],
  "B": [11, 7, 18],
  "PlayerSkills": [[10, 1], [11, 4], [11, 5], [3, 0], [4, 4]],
  "minRounds": 4,
  "CoinConsumption": 5
}